111111111111
10000001E001
101010011101
1P0010000001
111111111111