1111111111111111111111111111111111111111111111111111
11E00000001111000000001C0000000000100000000000000001
111111111000C000000000000001111100000000100000000001
100000000100000000000111000000001111000000X000000001
100011100100000000111110000000X000000001000000000001
10000P1C000000100000000000100000001000000010000C0001
1111111111111111111111111111111111111111111111111111
