11111111111111111111111111111111111
10000000100000000000000000010000001
11111100000000000010000000000011111
11000000000010000000000010C00000011
11100000000000000000000000000100111
11100000000001111011110000000000111
11100000000001000000010000000000111
11100000001001000000010010001000111
11100000000000001P1C000000001000111
1C001000000000001110000001100010001
10001000000010000E00001000000010001
10000000100000011010000001000000001
10010000000000000010000001000001001
10000000000000000000000001000000001
10000000000001000100001111000000001
11111100000000010C00000000000111111
100000000000C0000000000000000000001
100000000000000010000000000C0000001
11111111111111111111111111111111111