111111111111
1PC00001E001
1C1010011101
100010C00001
111111111111