11111111111111111111111111111111111111
11E00000001111000000001C00000000001001
111111111000C0000000000000011111000001
10000000010000000000011100000000111101
10001110010000000011111000000000000001
10P0001C000000100000000000100000001001
11111111111111111111111111111111111111