1111111111111111111111111111111111
100010000000000001100000010001C001
1C0010000000000001E000000010000001
1000100000000000000000000000000001
1000111110000000000000000000000001
100000000000C000000000010000000001
1000000000000000000000000000000001
1000000000000000001000000000000001
1010000001111110000000C00010000001
1000000001000000000000000000000001
1000000001000000X00000000000001001
1X00000001000000000000100000000001
1001000001000000000000000000000001
10P10000C100C00001000000000000C001
1111111111111111111111111111111111