11111111111111111111111111111111111
10000000100000000000000000010000001
11111100000000000010000000000011111
11000000000010000000000010C00000011
1110000X000000000000000000000100111
111000000000011110111100000X0000111
11100000000001000000010000000000111
11100000001001000000010010001000111
11100000000000001P1C000000001000111
1C00100000X000001110000001100010001
10001000000010000E0000100X000010001
10000000100000011010000001000000001
10010000000000000010000001000001001
10000000000000000000000001000000001
10000000000001000100001111000000001
1111110000X000010C0000000X000111111
100000000000C0000000000000000000001
100000000000000010000000000C0000001
11111111111111111111111111111111111